1111111111111111111111111111111111
1P00000000100000000000000000000001
1011111101011111110111111110111101
1000000101000000010C00000010000001
1111100101111101011111111011111101
1000100100000101010000010010000001
1010100111110101010111011010111101
1010100000010100010001000010000001
1010111111010111111101111110111101
1010000001010000000100000000100001
1011111101011111100111111111101101
1000000101000000100C00000000100001
1011110101111101111111111100111101
1000010100000100000000000100000001
1111010111100111111111100111111101
1000010000100000000000100000000001
1011111110101111111110101111111101
1000000010101000000010100000000001
1111111010101011111010111111111101
1C0000010001010000010000C000000001
1011111111010111110111111111111101
1000000000010000000000000000000E01
1111111111111111111111111111111111













































































